0000000000
0000001310
0115111110
0115000100
0025212120
0015013310
0018000000
0011000000
0000000000
